NO ./path_to_the_north_texture
SO ./path_to_the_south_texture
WE ./path_to_the_west_texture
EA ./path_to_the_east_texture

F 123,10,1
C 0,0,0

        1111111111111111111111111
        1000000000110000000000001
        1011000001110000000000001
        1001000000000000000000001
111111111011000001110000000000001
100000000011000001110111111111111
11110111111111011100000010001
11110111111111011101010010001
11000011111101011100000010001
10000000000000001100000010001
10000000000000001101010010001
11000000N0010101111101111000111
11000000000000011111111111111
1100000000000001
1100000000000001
1100000000000001
1100000000000001
1100000000000001
1100000000000001
1100000000000001
1100000000000001
1100000000000001
1100000000000001
1100000000000001
1111111111111111