NO textures_test/img_test2.xpm
SO textures_test/img_test24.xpm
WE textures_test/img_test4.xpm
EA textures_test/img_test6.xpm

F 123,10,1
C 200,200,200

        1111111111111111111111111
        1000000000110000000000001
        1011000001110000000000001
        1001000000000000000000001
111111111011000001110000000000001
100000000011000001110111111111111
11110111111111011100000010001
11110111111111011101010010001
11000011111101011100000010001
10000000000000001100000010001
10000000000000001101010010001
1100000000010101111101111000111
10000000000000111111111111111
1100000000000001
1000000000000011
1100000000000001
1000000000000011
1100000000000001
1000000000000011
1100000000000001
100000F000000011
110000S000000001
1000000000000011
1100000000000001
1111111111111111