NO /home/nmartin/Documents/test/textures/dog4.xpm
SO /home/nmartin/Documents/test/textures/dog5.xpm
WE /home/nmartin/Documents/test/textures/dog2.xpm
EA /home/nmartin/Documents/test/textures/dog3.xpm

F 123,10,1
C 200,200,200

        1111111111111111111111111
        100000000011000000000M001
        1011000001110000000000001
        1001000000000000000000001
111111111011000001110000000000001
100000000011000001110111111111111
11110111111111011100000010001
11110111111111010101010010001
11000011111101011100000010001
10000S00000000001100000010001
10000000000000001101010010001
1100000000010101111101111000111
10000000000000111111111111111
1100000000000001
1000000000000011
1100000000000001
1000000000000011
1100000000000001
1000000000000011
1111111111111111