NO textures/dog6.xpm
SO textures/pom.xpm
WE textures/test.xpm
EA textures/dog.xpm

F 1,1,1
C 255,255,255

11111111111111111111111111111111111111111111111
10000000000000000000000000000000000000000000001
10000000000000000000000000000000000000000000001
1000000000000000000000S000000000000000000000001
10000000000000000000000000000000000000000000001
1000000000000001111111D111111110000000000000001
1000000000000001     101      10000000000000001
1000000000000001     101      10000000000000001
1000000000000001     101      10000000000000001
1000000000000001     101      10000000000000001
1000000000000001     101      10000000000000001
1000000000000001     101      10000000000000001
1000000000000001111111D111111110000000000000001
10000000000000000000000000000000000000000000001
10000000000000000000000000000000000000000000001
10000000000000000000000000000000000000000000001
10000000000000000000000000000000000000000000001
10000000000000000000000000000000000000000000001
10000000000000000000000000000000000000000000001
11111111111111111111111111111111111111111111111