SO textures/dog.xpm
WE textures/chat.xpm
NO textures/pom.xpm
EA textures/test.xpm

C 0,0,0
F 1,2,3

11111111111111111111111
1S1000100000000F0000001
10101011101111111111101
10101000100F00001000001
10101110111110101110111
100FD0100000101000D0101
11111011111010111010101
10000010001010001010101
1010111010101111101F101
101000F010D000001010001
10111111101111101011101
1010M000101000001010101
1010101110101D111010101
1010101000101000M010101
1010101011101010111F101
10001010100010101000001
1D111010101111101011111
10F01010100000D01000001
11101010111110101111101
10001010000010100F00101
10111011101110111010101
10001000100010001010101
11101110111011101010101
100000D0001F00001010D01
10111011101111111110101
10100000101000000000101
10111D11101111111011101
100000F00000000000D0001
11111111111111111111111

