EA textures_test/img_test10.xpm
NO textures_test/img_test17.xpm
WE textures_test/img_test22.xpm
SO textures_test/img_test7.xpm

F 239,23,123
C 100,100,100

            1111111111111
            101F000000001
            1011111111101
            1M00100000001
            1110D01111101
            1000101000101
            10111011101F1
            1F10000010101
            1011111010101
            1000101000101
11111111111111D11011101011111111111
100000F0100000001000001010000M00001
10111110D01010111111111010111111101
10100010101F10100000001F00100000001
1010101M101011101110101111101111111
10101010101000000M10101000D00010001
10101011101111111110101010111010101
10001010001000100000100010001010101
11111010111110101D11111110111010101
1000001M10000010100W10000010001F101
10111110101011101011101111101111101
100F000000101000100000100M000000001
11111111111110111011111011111111111
            10001010FM101
            1110111010101
            1000D00010001
            1011101111D11
            1000100010001
            1010111011101
            10100M1010001
            1010111010101
            1F10000000101
            1111111111111