NO textures/clichy.xpm
SO textures/champs.xpm
WE textures/metro.xpm
EA textures/st_lazare.xpm

F 100,100,100
C 200,201,200

111111            111111
1000011          1100001
10000011        11000001
100000011      110000001
1000100011    110F010001
10M010M011    1100010001
10001100011  11000110001
100011100011110001110001
10F011100011110001110001
10001 110001100011 10F01
10N01  1100D0M011  10001
11111   11111111   11111