NO textures/walid1.xpm
SO textures/walid2.xpm
EA textures/walid3.xpm
WE textures/walid4.xpm

F 1,1,1
C 1,1,1

111111111111111111111111111
100000000000000000000100001
100000000000000000000100001
100000000000000000000100001
10000000000000000000010MFF1
100000000000000000000D00FF1
10000000000000000000010MFF1
100000000000000000000100001
100000000000000000000100001
100000000000N00000000100001
111111111111111111111111111